0000000000000000
0000000000000000
0000000000000000
0000000000000000
0000000000000000
0000000000000000
2222222222222222
1111101111101111
1111111111111111
1100000000000111
1101111001110011
1111111111111111
nn
0000000000000000
0000000000000000
0000000000000000
0000000000000000
2222222222222222
1111111111111111
1111111111111111
1111111111111111
1111111111111111
1111111111111111
1111111111111111
1111111111111111
nn
0000000000000000
0022220222200000
0011110111100000
0011110111100000
0000000000000000
0000222220000000
0000111110000000
0000111110000000
0000000000000000
0000000000000000
0000000000000000
0000000000000000
