0000000000000000
0000000000000000
0000000000000000
0000000000000000
0000000000000000
0000000000000000
2222222222222222
1111111111111111
1111111111111111
1111111111111111
1111111111111111
1111111111111111
nn
0000000000000000
0000000000000000
0000000000000000
0000000000000000
0000000000000000
0000000000000000
0000000022222000
2200000011111000
1122200000000000
1111122000000000
1111111222222222
1111111111111111
nn
0000000000000000
0000000000000000
0000000000000000
0000000000000000
0000000000000000
0000000000000000
0000000000002222
0000000002221111
0000000221111111
0002222111111111
2221111111111111
1111111111111111
nn
0000000000000000
0000000000000000
0000000000000000
0000000000000000
0000000000000000
0000000000000000
2222200000000000
1111102222000000
1111101111002222
0000001111001111
0000000000001111
0000000000001111
nn
0000000000000000
0000000000000000
0000000000000000
0000000000000000
0000000000000000
0000000000000002
0000000000222201
0000222220111100
2220111110000000
1110111110000000
0000000000000000
0000000000000000
