0000000000000000
0022220222200000
0011110111100000
0011110111100000
0000000000000000
0000222220000000
0000111110000000
0000111110000000
0000000000000000
0000000000000000
0000000000000000
0000000000000000
