0000000000000000
0000001000100000
0000001000100000
0002200000002200
0000222222222000
2222222222222222
1111110110111111
1111111111111111
1110111111110111
1111011111101111
1111100000011111
1111111111111111
