0000000000000000
0000000000000000
0010000111111100
0011111100000100
0000000111111100
0000000000000000
2222222222222222
1111111111111111
1111111111111111
1111111111111111
1111111111111111
1111111111111111
