0000000000000000
0000000000000000
0000000000000000
0000000000000000
0000000000000000
0000000000000000
2222222222222222
1111101111101111
1111111111111111
1000000000000011
1111111111111111
1111111111111111
